NO textures/eagle.xpm
SO textures/greystone.xpm
EA textures/mossy.xpm
WE textures/redbrick.xpm

F 0,100, 0
C 225,30,0

           1111111111111111111111111
           1000000000110000000000001
           1011000001110000000000001
           1001000000000000000000001
   1111111110110000011100000000000E1
   10000000001100000111011111111111
11110111111111011100000010001
11110111111111011101010010001
11000000110101011100000000001
10000000000000001100000000001
10000000000000001101010010001
1100000111010101111101111000011
11110111111101011101111010001
11111111111111111111111111111
