NO textures/eagle.xpm
SO textures/greystone.xpm
EA textures/mossy.xpm
EA textures/mossy.xpm

WE textures/redbrick.xpm
F       220,   110, 69
C 225,30,69


           11111111111111011111111111
           10000000001100000000000001     
           10110N00011100000000000011
           1001000000000000000000001
   111111111011000001110000000000001
   100000000011000001110111111111111
11110111111111011100000010001
11110111  1111011101010010001
11000111 11111011100000010001
10000111111111X01100000010001
10000000000000001101010010001
1100000111010101111101111000111
111111111111111111111111111111





























