

sdfkk
lkasjdf



l

asdlkjf

aksldjfj
jkldasfj

1111111
11111111
10011
101001
1100N1
111111