NO textures/eagle.xpm
SO textures/greystone.xpm
EA textures/mossy.xpm

WE textures/redbrick.xpm
F 0, 0, 1
C 0,200,0


     
111111
1S001
10001
11111